111111111111111
100100000000001
100C01111100001
1P0011E0000C001
111111111111111