111111111111111111111
100000P00000000000001
101111111111100000001
101111111111100000001
101111111111100000001
101111111111100000001
101111111111100000001
100C000000000000E0001
111111111111111111111
