111111111111111111111
100000000000P00000001
101111111111111111101
10C00000000000000C001
101111011111101111101
100000010000010000001
101111110111110111101
100000000C00000000001
101111011111101111101
100C00000000000000E01
111111111111111111111
